11111111111111111111111111
10P0C00000001100000000C001
10111101111011011110111101
10111101111011011110111101
10111101111011011110111101
10000000000000C00000C00001
10111101011111111010111101
100000010000110C0010000001
11101101111011011110111111
1110110100000C000001011111
11101101011100111010111111
1110C000010C01000000011111
11111101011111111010111111
111111010000000C0010111111
11111101011111111010111111
10000000000011000000000001
10111101111011011110111101
10001100000000000000110001
11101101011111111010110111
100000010000110C001000C001
10111111111011011111111101
1E00C00C0CCC00000000000001
11111111111111111111111111